Autobiography	Autobiography of Charles Darwin	1887
CoralReefs	The Structure and Distribution of Coral Reefs	1842
DescentofMan	The Descent of Man, and Selection in Relation to Sex	1871
DifferentFromsofFlowers	The Different Forms of Flowers on Plants of the Same Species	1877
EffectsCrossSelfFertilization	The Effects of Cross and Self Fertilisation in the Vegetable Kingdom	1876
ExpressionofEmotionManAnimals	The Expression of Emotions in Man and Animals	1872
FormationVegetableMould	The Formation of Vegetable Mould through the Action of Worms	1881
FoundationsOriginSpecies	The foundations of the Origin of Species	1842
GeologicalObservationsSouthAmerica	Geological Observations on South America	1846
InsectivorousPlants	Insectivorous Plants	1875
LifeandLettersVol1	Life and Letters of Charles Darwin	1887
LifeandLettersVol2	More Letters of Charles Darwin	1903
MonographCirripedia	A Monograph of the Sub-class Cirripedia Vol 1	1851
MonographCirripediaVol2	A Monograph of the Sub-class Cirripedia Vol 2	1854
MovementClimbingPlants	The Movements and Habits of Climbing Plants	1865
OriginofSpecies	On the Origin of Species by Means of Natural Selection	1859
PowerMovemntPlants	The Power of Movement in Plants	1880
VariationPLantsAnimalsDomestication	The Variation of Animals and Plants under Domestication	1868
VolcanicIslands	Geological Observations on the Volcanic Islands visited during the voyage of H.M.S. Beagle	1844
VoyageBeagle	Journal and Remarks (The Voyage of the Beagle)	1839